000000000000000000000000000000000000000000000000000000000000000000000000000000000000000000000000000000000000000000000000000000000000000000000000000000
000000000000022000000000000000000000000000000000000000000000000000000000000000000000000000000000000000000000000000000000000000000000000000000000000000
000000000000211200000000000000000000000000000000002222000000000000000000000000000000000222200000000000000000000000000000000000000000000000000000000000
000000000000111100000000000200200000000000000022200000000000000000000000000000000000000000000000000000000000000000000000000000000000000000000000000000
000000000000000000000000002100120000000000222000000000000000000000000000000000000022220000000222222222220000000000000000000000000000000000000000000000
222222222220000001222222221100112000000000000000000000000000000000000000000022220000000000000111111111110000000000000000002220000000000000000000000000
111111111110000001111111111100111222222222222222220000002222222200000022220000000000000000022111111111112222222000002220000010000000000000000000000000
111111111110000001111111111100111111111111111111110000001111111120000000000000000000000000011111111111111111111000001000000012000022220000000000000000
111111111110000001111111111100111111111111111111110000001111111122200000000000000000000002211111111111111111111000221000000000000000000000000000000000
111111111110000001111111111100111111111111111111110000001111111111222200000000000000000001111111111111111111111000000000000000000000000002222222222222
111111111110000001111111111100111111111111111111110000001111111111111222222222222222222221111111111111111111111000000000000000000000000001111111111111
111111111110000001111111111100111111111111111111110000001111111111111111111111111111111111111111111111111111111000000000000000000000000001111111111111
111111111110000001111111111100111111111111111111110000001111111111111111111111111111111111111111111111111111111000000000000000000000000001111111111111