100000001111111111111111111111111111111111111111111111111111111111111111111111111111111111111111111111111111111111111111111111111111111111111111111111111111111111111111111111111111111111111111111111111111111111111111111111111111111111111111111111111111111111111111111111111111111111111111111111111111
100000000000001111100111000000000011111000000000111111000000000000000000000000000000000111000011000000111111000000000000000000000000001111111111111111111111111111111111100001110001110011110011100000000000000000000000000000000000001110000000000111111000111100000000000000011110000001110000000000000111
100000000000000001000000000000000001111000000000001111000000000000000000000000000000000000000011000000111111000000000000000000000000000111111111111111111111111111111111100001110001110011110011100000000000000000000000000000000000000000000000000111111000000000000000000000011110000000000000000000000111
100000000000000000000000000000000000111000000000001111222200002222222000000000000000000000000110000000111111000000000000000000000000000011111111111111111111111111111111110001110001110011110011100000000000000000000000000000000000000000000000000000000000000000000000000000011110000000000000000000000111
100000000000000000000002222220000000000000000000000111000222000111111000000000002200000000000110000000111111100000000000000000000000000001111111111111111111111111111111110001110001110011110011100000000000000000000000000000000000000000000000000000000000000000000000000000001000000000000000000000000111
100000000000000000000021111110000000000000000000000111000000000111111002000000001100000000000000000000000011100000000000000000000000000001111111111111111111111111111111110001110001110011110011100000000000000000000000000000000000000000000000000000000000000000000000000000000000000222222222222222000011
100000000000000000000211111110000000000000000000000001000000011111111001000000221000000000000000000000000000000000000000000000000000000000111111111100111111111111111111110001110001110011110011100022222222200222222220000000000000000000000022000000000000000000000000000000000000000000001111111110000001
100000000000000000000111111110022222220000000000000001111110000001111001200000100000020000000000000000000000000000002220000000000000000000011111111100011110000000111111100001100001110011110011100011111100100100111000000000000000000222200011000000000000000000000000000000000000000000001111111110000001
100000000000000000002111111110011111110000000000000001111111000001111000120002100000010000000002100000000000000002221110000000022222222000011111111100001101000000000111100000000001110011110011100011000000002100000000000000000000000111100011000000000022000000000000022222222222222200001111111110000001
100000000222220022221111111110011111110000000000000000000011110001111000011111000000012000000211000000000000000001111112222222211111111000001111111000000000000000000011000000000000000001110000000011000000000000000000000000000000000110002211220000000011000000000000011111100001111100001111111110000000
100000000111110011111111111110000000000002222220000000000011100111111000000000000000001220002100000000000000022001111111111111111111111200000011111000000000000000000000000002220000000001110000000011000002222222222200222222000222200110001111110022222211000000000000000000000000011100001111111110000000
100000002111110000000000000000000000000001111110000000000000000111111000000000000000000011111000000220000000210001111111111111111111111120000001111000000000000000000000000001110000000000000022200011000000011111111100111111000111100110000000000011111111000000000000000000000000011100001111111111000000
100222221111110000000000000000000000000001111110000000000000000111111000000000000000000000000000000010000002100001111111111111111111111112000000000000000000022000000000000001110002220000000011122011111110000011111100000000000111100000000000000011111111002222222222222200022200011100001111111111000222
122111111111110000000000000000000000000000000000002222220000000111111000000000000000000000000000000012000021000001111111111111111111111111200000000000222222211122000000000021110001112000220011111011111111000011111100000000000111100000000000000000000000001111111111111100000000011100001111111111000011
111111111111110000000000000000000000000000000000001111111000001111111000000000000000000000000000000001111110000001111111111111111111111111122000000000111111111111000000002211110001110002110011111000000000001111111100000000000000000000000000000000000000001111111111111100000000011100000111111111100011
111111111111110000000000000000000000000000000000000000111000001111111000000000000000000000000000000000000000000001111111111111111111111111111200000000000000000000000000221111110001110001110011111000000000111111111100000000000000000000000000000000000000001111111111111100000000011100000111111111100011
111111111111110000000000000000000000000000000000000000011000111111111000000000000000000000000000000000000000000001111111111111111111111111111122222222000000000000002220001111110001110001110011111000000001111111111100000000000000000000000000000000000000001111111111111100000000011100000111111111100011
111111111111110000000000000000000000000000000000000000011000111111111000000000000000000000000000000000000000000001111111111111111111111111111111111111000000000002221100001111110001110001110011111111111111111111111100000000000000000000000000000000000000001111111111111100000000011100000111111111100011
111111111111110000000000000000000000000000000000000000111000111111111000000000000000000000000000000000000000000001111111111111111111111111111111111111000000000021111100001111110001110001110011111111111111111111111100000000000000000000000000000000000000001111111111111100000000011100000111111111100011
111111111111110000000000000000000000000000000000000000111001111111111000000000000000000000000000000000000000000001111111111111111111111111111111111111001100110011110000001111110001110001110011111111111111111111111100000000000000000000000000000000000000001111111111111100000000011100000011111111100011
