111111000000000000000001111000000000000000000000000000000000000000011100000000000000111111111111111100000000000000000000000000000000000000000000000000000000000000000000000000000000000000000000000000000011111000000000000011111110000001111100011100001111000000001111000100000000000000011111100001111111
111111000000000000000001111000000000000000000000000000000000000000011100000000000000111111111111111100000000000000000000000000000000000000000000000000000000000000000000000000000000000000000000000000000011100000000000000011111110000001111100011100001111000000001111000100000000000000011111100001111111
111111000000000000000001111000000000000000000000000000000000000000000000000000000000111111111111111100000000000000000000000000000000000000000000000000000000002222222222000000000000000000000000000000000001100000000000000011111110000001111100011100001111000000011111000100000000000000000000000000110011
000011000000000000000001111000000220002220002220002220000220000000000000000000000000111111111111111100000000000000000000000000002222200000000000000000000000001111111111000000000000000000000000000000000000000000000000000011111110000001111100000000001111000000111111000100000000000000000000000000000000
000000000000000000000001111000022110001110001110001110000110000000000000000000000000000000000000000000002222222222222000000000000000000022222220002222200000001111111111000000000000000222222000000000000000000000000000000011111110000001111100000000001111000000111111000100000002222000000000000000000000
000000000000000000000000000000011110001110001110001110000110000000000000000000000000000000000000000000000000000001111000002222000000000011111110001111100000001111111111222222222200000111111000000000000000000000000000000011111110000001111100000000001111000000111111000100000000000000000000000000000000
000000000000000000000000000002211110001110001110001110000110000000000222200000022220000000000000000000000000000001111000000000000000000011111110001111122222221111111111111111111100000000000000000000000000000000000000000011111110000001111100000000000000000000111111000122000000000002220000000000000000
000000000000000000222222222221111110001110001110001110000110000000000000000000000000000000000222222222000000000000000000000000000000000011111110001111111111111111111111111111111100000000000000022222200000000000000000000000000000000000000000000000000000000000111111000111222000000000000000220000222222
000000000000000000111111111111111110000000000000000000000000000222000000000000000000000002222111111111000000000000000000000000000000000011111110001111111111111111111111111111111100000000000000011111100000000000000000000000000000000000000000000000000000000000000000000111111000000000000000000000111111
000000000000000000000000000000000000000000000000000000000000000111000000002222000000022221111111111111000000000000000000000000000000000010000000001111111111111111111111111111111100000000000000000000000000000000000000000000000000000000000000000000000000000000000000000000000000000000000000000000111111
000000000002222200000000000000000000000000000000000000000002222111220000000000000000011111111111111111000000000000002222222222222222222200000000001111111111111111111111111111111100000000000000000000000000000222222222220000000000000000000000022222200000000000000000000000000000000000000000000000111111
000000000001111100000000000000000000000000000000000000000001111111110000000000000000211111111111111111000000000000221111111111111111000000000000001111111111111111111111111111111102220000000000000000000000000111111111110000000000000000002200010001110000000000000000000000000222220000000000000000111111
000000000001111102222222222222222222000000000000000000000001111111110000000000000022111111111111111111000000000002111111111111111110000111111110001111111111111111111111111111111100000002220000222000000000000111111111110000000000002222000000000000011000000000000000000000022111110000000000000000111111
222222222201111101111111111111111111220000000000000000000001111111112222200002222211111111111111111111000000022221111111111111111100000111111110001111111111111111111111111111111100000000000000000000000022222111111111112222222220000000000000000000001000000000000000000000011111110002222200001222111111
111111111101111101111111111111111111112200000000000000002221111111111111100001111111111111111111111111000002211111111111111111111100000111111110001111111111111111111111111111111100000000000000000000000011111111111111111111111110000000000000000000001110000000000000000000000000000001111122000000111111
111111111101111101111111111111111111111122000000000000001111111111111111100001111111111111111111111111000221111111111110000000000000001111111110001111111111111111111111111111111100000000000000000000000011111111111111111111111110000000000000000000001111000000000000000000000000000001111111000000111111
111111111101111101111111111111111111111111220000000002221111111111111111100001111111111111111111111111222111111111111110000000000000111111111110001111111111111111111111111111111100002220000222000022220011111111111111111111111111111111111111111111111111100000000002222222000000000000000000000000111111
111111111101111101111111111111111111111111112200000001111111111111111111100001111111111111111111111111111111111111111110000000000011111111111110001111111111111111111111111111111100000000000000000000000011111111111111111111111111111111111111111111111111100000000001100111000000000000000000000000111111
111111111101111101111111111111111111111111111122000221111111111111111111100001111111111111111111111111111111111111111110111100001111111111111110001111111111111111111111111111111100000000000000000000000011111111111111111111111111111111111111111111111111110000000000000000000000000000000000000000111111
111111111101111101111111111111111111111111111111000111111111111111111111100001111111111111111111111111111111111111111111111111111111111111111110001111111111111111111111111111111100000000000000000000000011111111111111111111111111111111111111111111111111111000222200000000000000000000000000000000111111