111111111111111111111111111111111111111111111111111111111111111111111111111111111111111111111111111111111111111111111111111111111111111111111111111110001111111111111111111111111111111111111111111111111111111111111111111111111111111111111111111111111111111111111111111111111111111111111111111111000011
110000001111111111100111000000000011111111111110000111111111111000011000011000001110111111111111111100000000000000000000000000000000000000000000000110000000000000000000000000000000000000000000000000000000000000000000000000000000000000000000000000000000000000000000000000000000000000000000000000000011
100000001111111111100111000000000001111111111100000001111111110000000000000000000000011111111111111100000000000000000000000000000000000000000000000110000000000000000000000000000000000000000000000000000000000000000000000000000000000000000000000000000000000000000000000000000000000000000000000000000011
100000001111111111100111000000000000111111111000000000011110000000000000000000000000001111111111111100000000000000000000000000000000000000000000000012000000000000000000000000000000000000000000000000000000000000000000000000000000000000000000000000011011000000000000000000000000000000000000000000000011
100000001111111110000111000000000000000111100000000000000000000000000000000000000000001111111111111100000000000000000000000000000000000000000000000000000000000000000000000000000000000000000000000000000000000000000000000000000000000000000000000000011011000000000000000000000000000000000000000000000011
100000001111111110000010000000000000000000000000000000000000000000222222222222222000001111111111111100000000000000000000000000000000000000000000000000002222222002220022222200222002222222000000000000000000000000000000000000000000000000000000000000010001000000000000000000000000000000000000000000000011
100000001111111100000010000000000000000000000000000000000000000000111111111111111100000111111111111100000000000000000000000000000000000000000000000000000111111000000011111100000001111111000000000000000000000000000000000000000000000000000000000000010001000000000000000000000000000000000000000000000011
100000001111100000000000000000000000000000000000000000000000002200111111111111111110000111111111111100000000000000000000000000000000000000000000000000020111111200000211111120000021111111000000000000000000000000000000200002000000000000000000000000010001000000000000000000000000000000000000000000000011
100022111111100000000000000000000000000000000000000000000000001100111111111111111110000011111111111100000000000000000000000000000000000000000000000002000111111000000011111100000001111111222000000000000000000000000002100001200000000000000222222200000000000222222222000022222222220000000000000000000011
100000111100000000000000000000000000000000000000000000000000001100111111111111111111000011111111111100000000000000000000000000000000000000000000000200000111111000000011111100000001111111111000000000000000000000000021100001120000000000000100000100000000000111111111000011111111110000000000000000000011
122000111100000000000000000222220000000000000000000000000022001100111111111111111111100001111111111100000000000000000000000000000000000000000000000000000111111000000011111100000001111111111000000000000000000000000211100001112000000000000000000000010001000111100000000000000011110000000000000000000011
100000111100000000000000000111110000000000000000000000000011001100111111111111111111100001111111111100000000000000000000000000000000000000000000220000000111111000000011111100000001111111111222000000000000000000002111100001111200000000000000000000010001000111100000000000000011110022000000000000000011
100022111100000000000000000000000022222000000000000000220011001100111111111111111111110001111111111100000000000000000000000000000000000000000000000000000111111000000011111100000001111111111111000000000000000000021111100001111120000000000200000200010001000000000000000000000000000000000000000000000011
100000111100000000002222200000000011111000000000000000110011001100111111111111111111110000111111111100000000000000000000000000000000000000002220000000000111111000000011111100000001111111111111000000000000000000211111100001111112000000000122222100012021000000000000000000000000000000002000000000000011
122000111100000000001111100000000000000000220022002200110011001100111111111111111111111000011111111100000000000000222200000222200000000000000000000000000111111000000011111100000001111111111111222222222222222222111111100001111111111111000000000000011011000000000000000000000000000000000000000000000011
100000111100000000000000000000000000000000110011001100110011001100111111111111111111111000000000000000000000220000000000000000000000000000000000000000000111111000000011111100000001111111111111111111111111111111111111100001111111111111000000000000000000000000000000000000000000000000000020000000000011
100022111100000001100000000000000000000000110011001100110011001100111111111111111111111100000000000000000000110000000000000000000000002222200000000000000111111000000011111100000001111111111111111111111111111111111111100001111111111111000000000000000000000000000000000000000000000000000000200000000011
100000011000000001100000000000000000000000110011001100110011001100111111111111111111111100000000000000000000110000000000000000000000000000000000000000000111111000000011111100000001111111111111111111111111111111111111100001111111111111000000000000000000000000000000000000000000000000000000002000000011
110000000000000111110000000000000000000000110011001100110011001100111111111111111111111111111111111122222222112222222222222222222222200000000000000000000111111000000011111100000001111111111111111111111111111111111111100001111111111111000000000000000000000000000000000000000000000000000000000020000011
111111111111111111111100000000000000000000110011001100110011001100111111111111111111111111111111111111111111111111111111111111111111100000000000000000000111111000000011111100000001111111111111111111111111111111111111100001111111111111000000000000000000000000000000000000000000000000000000000000202211