111111111111111111111111111111111111111111111111111111111111111111111111111111111111111111111111111111111111111111111111111111111111111111111111111111111111111111111111111111111111111111111111111111111111111111111111111111111111111111111111111111111111111111111111111111111111111111111111111111111111
100000000000000000000000000000000000000000000011111110000001111111111111111100000000000000000000000000000000000000000000000000000001110000000000000000000000000000000010000100001000000100000000000111111111111111111111111110000000000000000000000000000000000000000000000000000000000000000000000000000001
100000000000000000000000000000000000000000000000111110000000111111111111111100000000000000000000000000000000000000000000000000000000000000000000000000000000000000000010000100001000000100000000000011111111100001111111111110000000000000000000000000000000000000000000000000000002220002220022200000000001
100000000000000000000000000000000000000000000000011110000000011111111111111000000000000000000000000000000000000000000000000000000000000000000000000000000000000000000010000100001000000100000000000000110000000011111111111110000000000000000000000000000000000000000000002200000000000000000000000002222222
100000000000000000000000000000000000000000000000000000000000001111111111100000000222222222222222222222222222222222220000000000000000000000000000000000000000000000000010000100001000000100000000000000000000000011111111111110000000001111111111111111100112222222222222221122220000000000000000002001111111
100000000000000000000000000000000000000000000000000000000000000000111110000000002111111111111111111111111111111111110000000000000000000000000000000000000000000000000000000100000000000100000000000000000000000111111111111110000000001111111111111111001111111111111111111111110000000000000000000001111111
100000000000000000000000000000000000000000000000000000000000000000000000000000000000000000000000000000000000000000000000002222222222200000000000000000000000000000000000000100000000000000000000000000000000011111111111111110000000001111111111111110011110000000000000000000000000000000000000200001111111
100000000000000000000000000000000000000000000000000000000000000000000000000020000000000000000000000000000000000000000000001111111111122000000000000000000000000000000000000100000000000000000000000000000001111111111111111110000000001111111111111100111110000000000000000000000000000000000000000001111111
100000000000000000000000000000000000000000000000000000000000000000000000000002000000000000000000000000000000000000000000001111111111111220000000000000000000000000000010000000000000000000000000000000000011111111111111111110000000001111111111111001111110000000000000000000000000000000000020000001111111
100000000000000000000000000000000000000000000000000000000000000000000000000000000000000000000000000000000000000000000000001111111111111112000000000000000000000000000010000000001000000000000000000000011111111111111111111110000000001111111111110011111110000000000000000000000000000000000000000001111111
100000000002222222200000000000222222220000000000000000000000000000000000000000002000000000000000000000000000000000000000001111111111000000000000020000000000000000200010000000001000000222222222222011111111111111111111111110000000001111111111100111111110000000000000000000000000000000002000000001111111
100000000000011110000000000000001111000000000000000000000000000000000000000000020000000000000000000000000000000000000000001111111100000000022200012000000000000002100010000000001000000111111111111011111111111111111111111110000000000000000000000000000000000000000000000000000000000020000000000001111111
102222222200011110002222222200001111000000000000000000000000000000000000000000000000000000000000000000000000000000000000001111111000000000000000011200000000000021100010000100001000000111111111111011111100000000000000000000000000000000000000000000000000000000000000000000000000000000000000000001111111
100011110000011110000011110000001111000022222222000000000000000000222200002222000000000000000000000000000000000000000000001111111000000000000000011100000000000011100010000100001000000111111111111011110001111111111111111110000000001111111111111111111110000000000000000000000000020000000000000001111111
100011110000011110000011110000001111000000111100000000000000000000000000000000000000000000000000000000000000000000000000001111111111111111111100011120000000000211100010000100001000000111111111111011100011111111111111111110000000001111111111111111111110000000000000000000000020000000000000000001111111
100011110000011110000011110000001111000000111100000000000000000000000000000000000000000000000000000000000000000000000000000000000000000000000000011112000000002111100010000100001000000111111111111011101111111111111111111110000000021111111111111111111110000000000000000000020000000000000000000001111111
100011110000011110000011110000001111000000111100022222222000000000000000000000000000000000000000000000000000000000000000000000000000000000000000211111000000001111100010000100001000000111111111111011001111111111111111111110000000001111111111111111111110000000000000000200000000000000000000000001111111
100011110000011110000011110000001111000000111100000111100000222222222222222222222000222222220000222222220000022222222000000000000000000000000000011111200000021111100010000100001000000111111111111011011111111111111111111110000000000000000000000000000000000000000002000000000000000000000000000001111111
100011110000011110000011110000001111000000111100000111100000111111111111111111111000111111110000111111110000011111111000002222222222222222220000011111120000211111100010000100001000000111111111111000011111111111111111111110000000000000000000000000000000000000020000000000000000000000000000000001111111
100011110000011110000011110000001111000000111100000111100000111111111111111111111000111111110000111111110000011111111000021111111111111111112000011111111111111111100010000100001000000111111111111111111111111111111111111112222222221111111111111111111110000200000000000000000000000000000000000001111111